Vocab & Phrases:
- pandiculation - yawning and stretching
- thaumaturgy - the performing of miracles or magic
- propinquity - nearness
- velleity - a slight wish or inclination
- osculation - the act of kissing; a kiss
- folie à plusieurs -  the madness of many
- contretemps - something inopportune or embarrassing
- longueur - a tedious passage in a work of literature or performance art
- sesquipedaliophobia - the fear of long words (alternately Hippopotomonstro-Sesquipedaliophobia)
- nescience - lack of knowledge or awareness
- eleemosynary - relating to charity; charitable
- L’esprit de l’escalier or esprit d'escalier (stairway wit) is the sense of thinking of a clever comeback in an encounter when it is too late. The phrase can be used to describe a riposte to an insult, or any witty, clever remark that comes to mind too late to be useful—when one is on the “staircase” leaving the scene of the encounter. The phenomenon is usually accompanied by a feeling of regret at having not thought of the riposte when it was most needed or suitable.
- shibboleth - a word, pronunciation, saying, belief, practice, etc., that distinguishes one group from another
- sui generis - unique
- sapid - having flavor, especially a strong pleasant flavor
- serodiscordant - used to describe a couple in which one partner is HIV positive and the other is HIV negative
- macropterous - having large or long wings
- Enochlophobia - fear of crowds
- atelier - A workshop, studio (at-l-YAY)
- Numquam ponenda est pluralitas sine necessitate -- Original Latin text of Occam's Razor; roughly "Plurality should never be posited without necessity.
- syncretism - the amalgamation of different religions, cultures, or schools of thought
- eructation - the act of belching; a belch
- noblesse oblige - the moral obligation of those of high birth, powerful social position, etc., to act with honor, kindness, generosity, etc.
- omphaloskepsis - self-absorbed, navel-gazing
- mallemaroking - the carousing of seamen in icebound ships
- spanghew - to cause (esp. a toad or frog) to fly into the air off the end of a stick
- scrimshanker - one who accepts neither responsibility nor work
- tmesis - to break one word with another. e.g. un-fucking-believable
- quidnunc - one who gossips
- ischial callosities - the leather-like pads on a monkey's ass
- cyptomnesia - literally "buried memory", the process of forgetting the source of some information and assuming you've known it all along
- urt - a leftover bit
- termagant - a quarrelsome shrew of a woman
- petrichor - the sweet smell of rain on dry earth
- floccinaucinaucinihilipolofocation - the estimation of something as valueless
- crepuscular - of/like/relating to twilight
- sinecure - a position or office that requires little or no work but provides a salary
- kakistocracy - the government of a state by the worst citizens
- chthonic - dead, underground, of the nether world
- palimpsest - a parchment or other writing surface on which the original text has been effaced or partially erased, and then overwritten by another
- tintinnabulation - a sound made by the ringing of a bell
- maieutic - relating to or resembling the Socratic method of eliciting new ideas from another; intellectual midwifery
- borborygmus - the rumbling sound that comes from an empty stomach
- fugue - the stuffy atmosphere of a poorly ventilated space
- metanoia - the act or process of changing one's mind or way of life
- chatoyant - something that glows from deep within, like star sapphires or highly polished hard woods
- pangram - a sentence, verse, or phrase that contains all of the letters of the alphabet
- gestalt - an organized whole that is perceived as greater than the sum of it's parts
- ren - Confucian concept; inadequately conveyed by "benevolence," that quality which is quintessentially human, which can only be cultivated through interaction with others, and which a solitary person cannot manifest.
- ex nihilo - Latin, "from nothing"
- antimacassar - a piece of cloth put over the back of a chair to protect it from grease or dirt, or as a decoration
- prosopagnosia - the inability to recognize people by their faces
- valediction - the action of saying farewell; a statement or address made at or as a farewell
- aporia - difficulty determining the truth of an idea due to equally valid arguments for and against it.
- zugzwang - a situation in which a player is limited to moves that have a damaging effect
- apodictic - necessarily true or logically certain
- ambsace - the smallest amount or distance
- polysemous - having a diversity of meanings
- conglobate - to form into a ball
- pleonasm - the use of more words than are necessary to express an idea
- dilatory - given to, or marked by, procrastination or delay
- weltschmerz - sentimental pessimism; sorrow that one feels and accepts as one's necessary portion in life
- gynotikolobomassophile - one who loves to nibble women's earlobes
- meupareunia - Sexual activity enjoyed by only one of the participants
- adytum - a sacred place that the public is forbidden to enter; an inner shrine
- filiopietistic - pertaining to reverence of forebears or tradition, especially if carried to excess.
- enchiridion - A handbook; manual
- nephalist - a teetotaler
- nubilous - Cloudy or foggy; obscure or vague, indefinite
- bildungsroman - a novel about the education and development of a young protagonist
- gossypiboma - A surgical sponge accidentally left inside a patient's body.
- zemblanity - Intentional unhappiness or bad luck occurring as expected - the opposite of serendipity.
- tyrosemiophile - One who collects cheese labels.
- blissom - to bleat with sexual desire
- fritinancy - the buzzing and chirruping of insects such as cicadas.
- forglopned - old english word  meaning "overwhelmed with astonishment".
- scrobiculate - having many small grooves
- xeric - of, pertaining to, or adapted to a dry environment
- satrap - a subordinate ruler, often a despotic one
- paraph - a flourish made after a signature, as in a document, originally as a precaution against forgery
- obnubilate - to cloud over; becloud; obscure
- prolepsis - the anticipation of possible objections in order to answer them in advance. The use of a descriptive word in anticipation of its becoming applicable.
- allochthonous - not formed in the region where found.
- darg - a day's work
- pasquinade - a satire or lampoon, especially one posted in a public place
- genethliac - of or pertaining to birthdays or to the position of the stars at one's birth
- mordacious - sharp or caustic in style, tone, etc.; biting or given to biting.
- battology - wearisome repetition of words in speaking or writing.
- sonder - (noun) the realization that each random passerby is living a life as vivid and complex as your own
- apodysophilia - A feverish desire or undue eagerness to undress
- lemniscate - the infinity symbol, from a Latin word meaning "decorated with ribbons"
- sarchasm - (neologism) the gulf between the person who makes a sarcastic comment and the person who doesn't get it
- pilkunnussija - (Finnish) literally: "comma fucker"; someone who believes it's their job to point out all spelling mistakes
- edacity - voraciousness; appetite
- ploce - repetition of a word or phrase to gain special emphasis or indicate an extension of meaning
- boniface - any landlord or innkeeper
- lese majesty - an attack on any custom, instition, belief, etc., held sacred or revered by numbers of people
- xanthic - of or pertaining to a yellow or yellowish color
- Knismesis - light tickling
- Mumpsimus - one who obstinately sticks to their old ways or ideas in spite of evidence that they are wrong
- Tsundoku - the practice of buying a pile of books and then not getting around to reading them.
- quincunx - an arrangement of five objects in a square or rectangle, one at each corner and one in the middle
- gymnologise - to dispute or have an argument naked.
- fudgel - (18th cent.) Pretending to work when you're not actually doing anything
- umbriferous - casting or making shade
- misoneism - hatred or dislike of what is new or represents change
- cathexis - the investment of emotional significance in an activity, object, or idea
- parageusia - an abnormal or hallucinatory sense of taste
- hibernaculum - a protective case or covering, especially for winter, as of an animal or a plant bud.
- clinomania - a obsessive or abnormal desire to stay in bed
- ochlophobia - an abnormal fear of crowds
- misology - distrust or hatred of reason or reasoning
- williwaw - a violent squall that blows in near-polar latitudes
- ailurophilia - a liking for cats, as by cat fanciers
- aubade - Music. A peice sung or played outdoors at dawn, usually as a compliment to someone.
- deipnosophist - a person who is an adept conversationalist at table.
- ambivert - one whose personality type is intermediate between extrovert and introvert
- omphaloskepsis - comtemplation of one’s own navel as part of a mystical exercise
- vittate - striped longitudinally
- anagnorisis - the critical moment of recognition or discovery, especially preceding peripeteia
- peripeteia - a sudden turn of events or an unexpected reversal, especially in a literary work
- withershins - in a direction contrary to the natural one, especially contrary to the apparent course of the sun; counter-clockwise
- grimalkin - a cat; an old female cat; an ill-tempered old woman
- accidence - the rudiments or essentials of a subject
- famulus - a servant or attendant, especially of a scholar or magician
- philosophaster - a person who has only a superficial knowledge of philosophy
- verbigeration - the constant or obsessive repetition of meaningless words or phrases
- Weltanschauung - a comprehensive conception or image of the universe and of humanity's relation to it
- thalassic - of or pertaining to seas and oceans
- subfuscous - slightly dark, dusky, or somber
- mysophobia - a dread of dirt or filth
- larrikin - disoderly; rowdy
- rubricate - to mark or color with red
- viridescent - slightly green; greenish
- incunabula - the earliest stages or first traces of anything
- niveous - resembling snow
- gleed - a glowing coal
- rugose - wrinkled; corrugated
- thaumaturge - a worker of wonders or miracles; magician
- Pickwickian - meant or understood in a sense different from the apparent or usual one; intentionally or unintentionally odd or unusual
- inutile - of no use or service
- butyraceous - of the nature of, resembling, or containing butter
- variorum - containing different versions of the text by various editors; containing many notes and commentaries by a number of scholars or critics
- sastruga - usually sastrugi. Ridges of snow formed on a snowfield by the action of the wind
- phillumenist - a collector of matchbooks and matchboxes
- formication - a tactile hallucination involving the belief that something is crawling on the body or under the skin
- magniloquent - speaking or expressed in a lofty or grandiose style; pompous; bombastic; boastful
- dysphemism - the substitution of a harsh, disparaging, or unpleasant expression for a more neutral one
- cantillate - to chant; intone
- funambulist - a tightrope walker
- oology - the branch of orinthology that studies birds' eggs
- badinage - light, playful banter
- brume - mist; fog
- caseous - of or like cheese
- argot - the special vocabulary of a particular profession or social group
- schlemiel - an awkward and unlucky person for whom things never turn out right
- atticism - concise and elegant expression, diction, or the like
- stelliferous - having or abounding with stars
- terpsichorean - pertaining to dancing
- sybaritic - characterized by or loving luxury or sensuous pleasure
- offing - the more distant part of the sea seen from the shore
- cineaste - any person, especially a director or producer, associated professionally with filmmaking
- hebetude - the state of being dull; lethargy
- lacustrine - of or relating to a lake
- ludic - playful in an aimless way
- aeonian - eternal; everlasting
- aposiopesis - a sudden breaking off in the midst of a sentence, as if from inability or unwillingness to proceed
- nimiety - excess; overabundance
- backpfeifengesicht - a face in need of a good punch
- eudaemonic - conducive to happiness
- groak - to stare longingly at someone who is eating in the hope that they will offer to share their food
- embonpoint - excessive plumpness; stoutness
- furphy - a false report; rumor
- inspissate - to thicken, as by evaporation; make or become dense
- fard - to apply cosmetics to the face
- villatic - of or relating to the country or to a farm; rural
- logomachy - an argument about words
- virgule - a short oblique stroke (/) between two words indicating that whichever is appropriate may be chosen to complete the sense of the text in which they occur
- paranomasia - punning, a pun
- lucubrate - to work, write, or study laboriously, especially at night
- amanuensis - a person employed to write or type what another dictates or to copy what has been written by another.
- illeism - the act of referring to oneself in the third person instead of first person
- froideur - an attitude of haughty aloofness; cold superiority
- surfactant - a substance that tends to reduce the surface tension of a liquid in which it's dissolved
- stochastic - randomly determined; having a random probability distribution or pattern that may be analyzed statistically but may not be predicted precisely
- bafflegab - incomprehensible or pretentious language, especially bureaucratic jargon
- martinet - a strict disciplinarian, especially in the armed forces
- mondegreen - a mishearing or misinterpretation of a phrase as a result of near-homophony, in a way that gives it a new meaning.
- soramimi - a homophonic translation of song lyrics; that is, interpreting lyrics in one language as similar-sounding lyrics in another language
- confelicity - delight in another person's happiness
- cabochon - a gem that has been polished but not faceted
- vitiate - to spoil or impair the quality or efficiency of
- tsundoku - buying books and not reading them. letting books pile up unread on floors or shelves or nightstands
- roman-a-clef - French for "novel with a key", a novel about real life overlaid with a facade of fiction. The characters represent real people and the "key" is a mapping of characters to real people, either provided by the auther or implied via epigraphs or other literary techniques. E.G. Animal Farm
- quadragesimal - of, like, or pertaining to Lent; lasting forty days
- enthymeme - a kind of syllogism, or logical deduction, in which one of the premises is unstated. E.G. If P & Q then R; but omitting P or Q (presumably because it's obvious and doesn't need to be explicitly stated)
- chiasmus - a grammatical structure that inverts a previous phrase. E.G. Don't sweat the petty and don't pet the sweaty.
- anthimeria - the usage of a word in a new grammatical form, most often the usage of a noun as a verb. E.G "google" in "I need to google it."

Pangrams:
- Waltz, bad nymph, for quick jigs vex. (28)
- Quick zephyrs blow, vexing daft Jim. (29)
- Sphinx of black quartz, judge my vow. (29)
- Two driven jocks help fax my big quiz. (30)
- Five quacking zephyrs jolt my wax bed. (31)
- The five boxing wizards jump quickly. (31)
- Pack my box with five dozen liquor jugs. (32)
- The quick brown fox jumps over the lazy dog. (35)
- Jinxed wizards pluck ivy from the big quilt. (36)
- Crazy Fredrick bought many very exquisite opal jewels. (46)
- We promptly judged antique ivory buckles for the next prize. (50)
- A mad boxer shot a quick, gloved jab to the jaw of his dizzy opponent. (54)
- Jaded zombies acted quaintly but kept driving their oxen forward. (55)
- The job requires extra pluck and zeal from every young wage earner. (55)

One-Liners:
- Imagine a world without hypothetical situations
- A Freudian Slip is when you say one thing but mean your mother
- He's so deep in the closet he's in Narnia.
- A pizza with a radius z and a thickness of a has a volume of pi*z*z*a
- The Italian version of "You can't have your cake and eat it too" is "You want your bottle full of wine and your wife drunk"
- I'm like the angle opposite the hypotenuse -- always right


Original Clevernesses:
- Der Strøöpwaffle Häusen
- Life advice to highschoolers: Don't get too excited when you read the Fountainhead.
- Resume line: Excellent attention to detale.
- vu déjá - when something actually does happen twice, but you don't remember the first time it happened (aka being a stoner)
- Paradoxymoron
- Defensestration - throwing oneself out a window in self-defense (e.g. to avoid being shot)
- One of the largest elevator service companies is the world is Schindler's Elevators. Talk about a missed marketing opportunity; why the hell wouldn't you name yourself Schindler's Lifts?
- Slackadaisical - a lackadaisical slacker

Interesting Facts:
- Before Mergenthaler's invention of the Linotype in 1884, no newspaper in the world had more than eight pages.
